3 3 3 3 3 3 3 3 3 3 3 3 3 3 3 3
3 3 3 3 4 5 3 3 3 3 3 3 3 3 3 3
3 3 3 3 3 3 3 3 3 3 4 5 3 3 3 3
3 3 3 3 3 3 3 3 3 3 3 3 3 3 3 3
3 4 5 3 3 3 3 3 3 3 3 3 3 3 3 3
3 3 3 3 3 3 3 3 3 3 3 3 3 3 3 3
3 3 3 3 3 3 3 3 3 3 3 3 3 3 3 3
3 3 3 3 3 3 3 3 3 3 3 3 3 3 3 3
3 3 3 3 3 3 3 3 3 3 3 3 3 3 3 3
0 0 0 0 0 0 0 0 0 0 0 0 0 0 0 0
1 1 1 1 1 1 1 1 1 1 1 1 1 1 1 1
1 1 1 1 1 1 1 1 1 1 1 1 1 1 1 1